16 8
0 295
56 57 0 48 49 0 0 0 0 0 0 0 0 0 56 57
0 0 0 50 51 0 0 0 0 0 0 63 0 0 0 0 
0 0 0 0 0 0 54 55 0 0 0 0 0 0 0 0 
0 0 0 0 0 0 0 0 0 0 48 49 0 0 0 0 
0 0 0 0 62 0 0 0 0 59 50 51 0 0 0 0 
44 45 0 0 0 0 0 0 0 0 0 0 0 59 63 0
46 47 60 0 0 0 0 0 0 0 0 0 62 0 0 0 
0 0 0 53 53 53 0 0 0 0 0 0 0 0 0 0