16 8
0 295
0 0 0 0 0 0 0 0 0 0 0 0 0 0 0 0 
0 0 26 0 0 5 6 0 0 0 0 0 26 22 27 28
0 0 0 0 0 7 8 22 0 0 27 28 0 0 0 0 
0 0 0 0 0 0 0 0 0 0 0 0 0 0 0 0 
0 0 0 0 0 0 0 0 0 1 2 0 0 0 0 0
0 0 1 2 0 0 24 25 0 3 4 0 0 0 5 6
24 25 3 4 26 0 0 0 0 0 0 0 26 0 7 8
0 0 0 0 0 0 0 0 0 0 0 0 0 0 0 0 
