16 8
0 295
0 0 0 0 0 0 0 0 0 0 0 0 0 0 0 0 
10 10 0 0 0 0 0 0 0 0 0 0 0 0 0 0
13 13 10 10 0 0 0 0 0 0 0 0 10 10 10 10
13 13 13 13 10 10 10 10 29 10 10 10 13 13 13 13 
13 13 13 13 13 13 13 13 13 13 13 13 13 13 13 13 
13 13 13 13 13 13 13 13 13 13 13 13 13 13 13 13 
13 13 13 13 13 13 10 10 10 10 10 13 13 13 13 13
10 10 10 10 10 10 13 13 13 13 13 10 10 10 10 10 