16 8
0 295
71 72 73 74 67 68 69 70 67 68 69 70 67 68 69 70
0 0 0 0 71 72 73 74 67 68 69 70 71 72 73 74
0 0 0 0 0 0 0 0 71 72 73 74 0 0 0 0 
65 0 75 0 0 0 0 0 0 0 0 0 0 0 0 0 
66 65 65 65 0 0 0 0 0 0 0 0 0 0 0 0 
0 0 0 0 0 0 0 0 0 0 65 65 0 0 0 0 
18 0 0 0 65 65 65 65 0 0 0 0 0 0 0 0 
65 65 65 65 66 66 66 66 65 65 69 69 65 65 65 65