16 8
0 295
0 0 0 0 0 0 0 0 0 0 0 0 0 0 0 0 
33 34 0 0 0 0 0 0 0 0 0 0 0 41 42 42
36 37 0 41 43 0 0 0 0 41 42 43 0 0 0 0 
39 40 0 0 0 0 41 43 0 0 0 0 0 0 0 0 
0 0 0 0 0 0 0 0 0 0 0 0 0 0 0 0 
0 0 0 41 42 43 0 0 0 32 33 34 0 0 0 0 
0 0 0 0 0 0 0 0 0 35 36 37 0 32 34 0
33 33 33 52 52 52 33 33 33 33 33 33 33 33 33 33