16 8
0 295
0 0 0 0 0 0 0 0 0 0 0 0 0 0 0 0
0 0 0 41 43 0 0 0 0 0 0 0 41 42 43 0
41 43 0 0 0 0 41 42 42 42 43 0 0 0 0 0
0 0 0 0 0 0 0 0 0 0 0 0 0 0 0 0
0 0 0 41 42 43 0 0 0 0 0 41 43 0 0 0
0 0 0 0 0 0 0 41 42 43 0 0 0 0 0 0 
0 0 0 0 0 0 0 0 0 0 0 0 0 0 0 0
33 33 33 52 33 33 33 33 33 33 33 33 33 33 33 33