16 8
0 295
0 0 0 0 0 0 0 0 0 0 0 0 0 0 0 0
0 0 5 6 0 0 22 0 24 25 0 0 0 5 6 0
0 0 7 8 0 26 0 0 19 0 0 26 0 7 8 27
0 0 0 0 0 0 0 0 20 0 0 0 0 0 0 0
0 0 0 0 0 0 0 0 21 26 0 0 0 0 0 0
0 5 6 0 0 0 26 0 0 0 0 26 0 0 0 0
18 7 8 24 25 0 0 0 0 0 0 0 27 28 22 26
0 0 0 0 0 0 0 0 0 0 0 0 0 0 0 0
