16 8
0 295
48 49 0 0 0 0 0 48 49 0 0 0 44 45 63 0
50 51 0 0 0 0 0 50 51 54 55 0 0 0 0 0
0 0 0 0 44 45 0 0 0 0 0 0 0 0 0 0
0 0 0 59 46 47 0 0 0 0 0 62 59 0 0 0 
0 0 0 0 0 0 0  59 0 0 0 0 0 0 0 0 
48 49 0 0 0 0 0 0 0 0 0 0 0 0 0 0 
50 51 60 0 0 63 0 54 55 0 0 62 56 57 0 0 
0 0 0 53 0 0 0 0 0 0 0 0 0 0 0 0 